EQS = "countries/Equestria.txt"
WHN = "countries/Whinnyapolis.txt"
WES = "countries/WestEquestrianShore.txt"
DRG = "countries/Dragon.txt"
BAL = "countries/Baltimare.txt"
OLE = "countries/Olenia.txt"
CRY = "countries/CrystalEmpire.txt"
SEV = "countries/Severiana.txt"
YAK = "countries/Yakistan.txt"
STL = "countries/StarlightTown.txt"
AED = "countries/Aedirn.txt"
BRG = "countries/Brugge.txt"
BRK = "countries/Brokilon.txt"
CID = "countries/Cidaris.txt"
KDW = "countries/Kaedwen.txt"
LAR = "countries/Lyria and Rivia.txt"
MHK = "countries/Mahakam.txt"
RED = "countries/Redania.txt"
SOD = "countries/Sodden.txt"
TEM = "countries/Temeria.txt"
KER = "countries/Kerack.txt"
BRM = "countries/Bremervoord.txt"
VRD = "countries/Verden.txt"
ANG = "countries/Angren.txt"
ELD = "countries/Ellander.txt"
CAR = "countries/Carreras.txt"
DRA = "countries/Drakenborg.txt"
MON = "countries/Montecalvo.txt"
DOL = "countries/Dol Blathanna.txt"
CIN = "countries/Cintra.txt"
ATT = "countries/Attre.txt"
DRI = "countries/Drains.txt"
DOA = "countries/Dol Angra.txt"
TOU = "countries/Toussaint.txt"
NAZ = "countries/Nazair.txt"
MAG = "countries/Mag Turga.txt"
GES = "countries/Geso.txt"
EBB = "countries/Ebbing.txt"
ETO = "countries/Etolia.txt"
GEM = "countries/Gemmera.txt"
VIC = "countries/Vicovaro.txt"
ROW = "countries/Rowan.txt"
YML = "countries/Ymlac.txt"
LID = "countries/Liddertal.txt"
THO = "countries/Thorax.txt"
TTT = "countries/TheTwinTowers.txt"
WET = "countries/Weter.txt"
MRF = "countries/MonarchistRestorationFront.txt"
TRS = "countries/Trotsylvania.txt"
NWN = "countries/NyWinghagen.txt"
GLF = "countries/GryffonianLiberationFront.txt"
GFF = "countries/Frontier.txt"
GRF = "countries/NovaGriffonia.txt"
CNC = "countries/CoalitionOfNorthernCities.txt"
BFJ = "countries/Boreasfjord.txt"
PNG = "countries/KingdomOfPingland.txt"
PNR = "countries/PinguinRepublic.txt"
DMD = "countries/Diamondia.txt"
PLV = "countries/PlumeVille.txt"
LDC = "countries/Luderclaw.txt"
ALH = "countries/Alexhafen.txt"
ALC = "countries/Alicornia.txt"
AMN = "countries/Amundsen.txt"
MOR = "countries/Morien.txt"
HOO = "countries/Hoorornd.txt"
ANT = "countries/Antax.txt"
ALB = "countries/Albion.txt"
PRA = "countries/Prance.txt"
NGF = "countries/NeighgaraFalls.txt"

# Not countries
TST = "countries/Test.txt" # is handling some stuff that is handled by SOL in eaw
WLD = "countries/Wilderness.txt"
WST = "countries/Wasteland.txt"